NO ./path_to_the_north_texture

WE ./path_to_the_west_texture


SO ./path_to_the_south_texture





EA ./path_to_the_east_texture


F 220,100,0
C 205,30,0

11111111111111111111111111
        1001011111
11111111000111111111
1100N111111000000
111111            