R   1000    500     
NO    ./textures_hi/mario.xpm
SO    ./textures_hi/mario.xpm
WE      ./textures_hi/mario.xpm
EA  ./textures_hi/mario.xpm
S    ./textures_hi/toad.xpm
F  238,245,93
C 34,218,240

11111111111111111111
12200000000000300061
12000000000000111111
10000000000000200041
100000100000000200W1
10000161000000002001
10000010000000500201
10000050000110000021
10000000000000000001
10005000000005000001
10000010500000000001
10050000000100000001
10000000011100050001
10000000010000000001
10550000110005011101
11000500000000001001
11111111111111111111