C 220, 115,   245
NO ./textures/64x64.xpm
SO ./textures/86.xpm
WE             ./textures/text2.xpm
EA   ./textures/newtexttext.xpm
F 60 , 22, 33

111111111111111111111111
11110000001100000000000011
1011000001110000000E000011
11110000000000001000000011
11111111111111111111111101
11111000001100000111011111111   
1111111111111111111111111111
