NO ./textures/1.xpm
SO  ./textures/2.xpm
WE ./textures/3.xpm
EA   ./textures/4.xpm

C 220,220,33
F 60,  2147483647,110

 111111111111111111111111111
100000000011000S0000000011
10110000011100000000000011
10010000000000001000000011
1111111110110000111000011
10000000001100000111011111
11110111111101011100000011
11110111100001101110101001
11110111100001101110101001
11110111100001101110101001
11110111100001101110101001
11110111100001101110101001
11110111100001101110101001
11110111100001101110101001
11110111100001101110101001
11000001110101011111010011
11111111111111111111111111